matter|重要，要紧，有关系
What’s the matter? |怎么了?出什么事了?
sore|疼痛的，酸痛的
have a cold |感冒
stomach|胃，腹部
stomachache|胃痛，腹痛
have a stomachache |胃痛
foot(复数feet)|脚
neck|颈，脖子
throat|喉咙
fever|发烧，发热
lie|躺，平躺
lie down |躺下
rest|剩余部分，其余;放松，休息
cough|咳嗽
X-ray|X光，X射线
toothache|牙痛
take one's temperature |量体温
headache|头痛
have a fever |发烧
break|休息，暂停;打破
take breaks|休息
take a break||休息
hurt|伤害，损害，使受伤
passenger|乘客，旅客
off|离开(某处);从…去掉
get off |下车
to one's surprise |使…惊讶，出乎…意料
onto|向，朝
trouble|麻烦，烦扰，问题
hit|碰撞，打，打击
right away |立即，马上
get into||陷入，参与
herself|她自己，她本身(she的反身代词)
bandage|绷带;用绷带包扎
sick|患病的，不适的
knee|膝盖
nosebleed|鼻出血
breathe|呼吸
sunburned|晒伤的
ourselves|我们自己(we的反身代词)
climber|登山者
be used to |习惯于…|适应于…
risk|风险，危险;冒险
take risks||冒险
take a risk ||冒险
accident|意外事件;事故
situation|状况，形式，情况
kilogram|公斤，千克
rock|岩石
run out|(of) |用尽，耗尽
knife|刀，餐刀
cut off |切除
blood|血
mean|意味着，意思是，意欲
get out of |离开，从…|出来
importance|重要性
decision|决心，决定，抉择
control|控制，支配，操纵
be in control of |掌管，管理
spirit|勇气，意志
death|死亡
give up |放弃
nurse|护士
clean up |打扫(清除)干净
cheer|欢呼
cheer up |变得更高兴，振奋起来
give out |分发，散发
volunteer|志愿者;义务做
come up with |想出，提出
put off|推迟
sign|标记，符号，标牌
notice|通知，公告;注意到
hand out |分发
call up |打电话给…某人，征召
used to |曾经…，过去…
lonely|孤独的，寂寞的
care for |照顾，非常喜欢
several|几个，数个，一些
strong|强壮的，强烈的
feeling|感觉，感触
satisfaction|满足，满意
joy|高兴，愉快
owner|所有者，物主
try out |参加…选拔，试用
journey|(尤指长途)旅行，行程
raise|抬起，举起，筹集，征集
alone|独自地，孤独地
repair|修理，修补
fix|修理，安装
fix up |修理，修补
give away |赠送，捐赠
take after |(外貌或行为)像
broken|破损的，残缺的
wheel|轮子，车轮;旋转
letter|信件，字母
Miss|小姐
set up |建立，设立
disabled|有残疾的，丧失能力的
make a difference|影响，有作用
blind|盲的，盲目的，失明的
deaf|聋的
imagine|想象，设想
difficulty|困难
open|打开
door|门
carry|携带，搬运
train|训练，培养
training|训练，培训
excited|激动的，兴奋的
kindness|仁慈，善良，亲切，善意
clever|聪明的，机灵的
understand|懂，理解
change|改变
interest|感兴趣;兴趣
sir|先生
madam|夫人，女士
rubbish|垃圾，废物
take out the rubbish|倒垃圾
fold|对折，折叠
mess|混乱，脏乱，食堂
throw|扔，投掷
all the time|频繁，反复
neither|二者都不;也不
shirt|运动衫，衬衫
as soon as|一…就…，尽快
pass|前行，经过，批准
borrow|借，借用
lend|借给，借出
finger|手指
hate|憎恶，讨厌
chore|杂务，乏味的工作
while |时候，而，然而
snack|小吃，点心，快餐
stress|精神压力，心理负担
waste|浪费，消耗
in order to|目的是，为了
provide|提供，供给，供应
anyway|无论如何,不管怎样，而且
depend|取决于，依靠，依赖
depend on|依靠于
develop|发展，壮大，开发，研制
independent |独立自主的，不受约束的
independence|独立
fair|公平的，公正的
unfair|不公平的，有偏见的
fairness|公正性，合理性
since|因为，既然
neighbor|邻居
take care of|照顾，处理
ill|生病的，有病的
drop|落下，跌落
allow|允许，准许
wrong|错误的
What's wrong?|哪儿不舒服?
midnight|午夜，子夜
look through|浏览，快速查看
guess|猜测，估计
deal|处理，应付
big deal|重要的事
work out|成功地发展，解决
get on with|和睦相处，关系良好
relation|关系，联系，交往
communicate|沟通,通信,通讯
communication|交流，沟通
argue|争论，争吵
cloud|云
elder|年级较长的
instead|代替
whatever|任何,不管什么,无论什么
nervous|紧张不安的
offer|提供，自愿给予
proper|合适的，适当的
secondly|第二，其次
explain|讲解，解释，说明
clear|清晰的，清楚易懂的
copy|复制
return|回来，返回，归还
anymore|不再，再也不
member|成员，会员
pressure|压力
compete|比赛，竞争
opinion|意见，想法，看法
skill|技能，技巧
typical|典型的
football|足球
cut out|删去，删除
quick|快的，迅速的
continue|继续，连续
compare|比较
compare…with|比较，对比
crazy|疯狂的，狂热的
development|发育，成长，发展
cause|原因;造成，使发生
usual|通常的，平常的
in one's opinion|依…|看
perhaps|可能，大概，也许
rainstorm|暴风雨
alarm|闹钟
go off|(闹钟)发出响声
begin|开始
heavily|在很大程度上，大量地
suddenly|突然地
pick up|接电话
pick up the phone|接电话
strange|奇怪的，陌生的，奇特的
storm|暴风雨
wind|风
light|电灯;点燃
report|报导，报告
area|范围，地域，地区
wood|树木，木材，树木
window|窗户
flashlight|手电筒，火炬
match|火柴，比赛
beat|敲打，打败
against|反对，对…不利
asleep|睡着的，熟睡的
fall asleep|进入梦乡，睡着
die down|逐渐变弱，逐渐消失
rise|上升，升起
fallen|倒下的，落下的
apart|分离，分开
have a look|看一看
icy|覆盖着冰的，冰冷的
kid|(口语)小孩;开玩笑，欺骗
realize|认识到，了解
make one's way|前往，费力地前进
passage|章节，段落
pupil|学生
completely|彻底地，完全地
shocked|震惊的，震撼的
silence|寂静，沉默
in silence|沉默，无声
recently|不久前，近来，最近
take down|拆除，往下拽，记录
terrorist|恐怖分子
date|日期，日子
tower|塔
at first|首先，最初
truth|真相，真理，事实
shoot|投篮，射击，发射
stone|石头
weak|虚弱的，柔弱的
god|上帝，神
remind|提醒，使想起
bit|一点，小块
a little bit|有点儿，稍微
silly|愚昧的;傻子，蠢货
instead of|代替，反而
turn into|变成
object|物体，目标，物品
hide|躲藏，隐藏
tail|尾巴
magic|魔法，巫术
stick|棍，棒;刺，戳，插
excite|使激动，使兴奋
Western|西方的，欧美的
once upon|从前
stepsister|继姐(妹)
prince|王子
fall in love|爱上，喜欢上
fit|适合，合身
couple|(尤指)夫妻，两人
smile|微笑
marry|与某人结婚
get married|结婚
gold|黄金，金币
emperor|皇帝
silk|丝绸
underwear|内衣
nobody|无人,没有任何人,谁也不
stupid|愚蠢的,傻的;傻子
cheat|欺骗，愚弄
stepmother|继母
wife|妻子
husband|丈夫
whole|全部的，整体的
scene|舞台，(戏剧)场景
moonlight|月光
shine|照耀，发光
bright|明亮的,发亮的;明亮地
ground|地面
lead|领导，主角;带路
voice|嗓音
brave|勇敢的
square|平方，正方形
meter|米
deep|深的
desert|沙漠
population|人口(数量),全体居民
Asia|亚洲
feel free|(可以)随便(做某事)
tour|旅行，观光
wall|墙
amazing|令人惊异的
ancient|古代的，古老的
protect|保护
wide|宽的，广阔的
as far as I know|就我所知
achieve|完成，实现
achievement|成就，成绩
southwestern|西南的,西南方向的
thick|厚的，浓的
include|包括，包含
freezing|极冷的，冷冻的
condition|条件，状况
take in|吸入，吞入
succeed|成功，实现目标，完成
challenge|挑战，考验
in the face of|面对(问题，困难)
force|力，力量
nature|自然界，大自然
even though|即使，虽然
even if|即使，虽然
ocean|海洋
the Pacific Ocean|太平洋
cm(centimeter)|厘米
weigh|称…重量
birth|出生，诞生
at birth|出生时
up to|到达(某数量，程度)，不多于
adult|成年人
bamboo|竹子
endangered |有危险的，濒临灭绝的，濒危的
research|研究，调查
keeper|饲养员，保管人
awake|醒着
excitement|激动，兴奋
walk into|走路时撞到
fall over|绊倒
illness|疾病，生病
remaining|遗留的，剩余的
or so|大约
artwork|艺术品，插图，图片
wild|野性的，野生的
government|政府
whale|鲸
protection|保护，保卫
huge|巨大的，极多的
dynasty|朝代，王朝
base|基础，基地
treasure|财宝，财富
island|岛屿
full of|满是…的，(有)丰富的
classic|经典著作，名著
page|(书或纸张的)页，面，张
hurry|匆忙，赶快
hurry up|赶快，急忙(做某事)
due|预期的，到期的
ship|船
tool|工具
gun|炮，枪
mark|分数，记号;作标记
sand|沙滩，沙
cannibal|食人肉者;同类相残的，凶残的
towards|向着，朝着，对于,关于
land|陆地，大地，国土;着陆
fiction|小说，虚构，编造
science fiction|科幻小说
technology|科技，工艺
French|法语，法国人(的)
pop|流行音乐
rock|岩石，摇滚乐
band|乐队
country music|乡村音乐
forever|永远
abroad|在国外，到国外
actually|真实地,实际上,说实在的
ever since|自从
fan|乐趣
southern|南方的
modern|现代的，现代化的
success|成功
belong|属于
one another|互相
laughter|笑，笑声
beauty|美丽，美好的事物
million|百万
record|记录，唱片;录制，录音
introduce|介绍，传入，引进
line|排，队，列
amusement|娱乐，消遣，游戏
amusement park|游乐场
somewhere|某处，在某处
camera|照相机
invention|发明，创造
invent|发明，创造
unbelievable |难以置信的,不真实的
progress|进步，进展
rapid|迅速的，快速的
unusual|特别的，不寻常的
toilet|坐便器，厕所
encourage|鼓励，激励
social|社会的
peaceful|和平的，平静的
tea art|茶艺
performance|表演，演出
perfect|完美的，理想的，完全的
tea set|茶具
itself|它自己，它本身
collect|收集
a couple of|一对，两个，几个
German|德语，德国人(的)
theme|题目，主题，作文
ride|骑，乘;(短途)旅程
province|省，省份
thousand|一千
thousands of|数以千计的，许许多多的
safe|安全的，保险的
simply|仅仅，只，不过
fear|恐惧，害怕
whether |不管…还是,或者…或者，是否
Indian|印度的，印度人的
Japanese|日本人,日语;日本的
fox|狐狸
all year around|全年
equator|赤道
whenever|无论何时
spring|春天
mostly|大多数地，主要地，通常
location|地点，位置
yard|院子
sweet|甜的，糖果
memory|记忆，记忆力，回忆
cent|分，分币
toy|玩具
bear|熊
maker|生产者，制造者
bread maker|面包机
scarf|围巾，披巾，头巾
soft|柔软的
soft toy|软体玩具，布绒玩具
check|餐馆账单;检查
check out|察看，观察
board|板子，甲板
board game|棋类游戏
junior|地位低下的
junior high school|初中
clear|清晰的，清澈的
clear out|清理，清除掉
bedroom|卧室
no longer|不再，不复
own|属于自己的
railway|铁路，铁道
part|部分，零部件
part with|放弃，交出
certain|某一，确定的，无疑的
as for|至于，关于
honest|诚实的，正直的
to be honest|说实在的
while |时候，一段时间，一会儿
truthful|诚实的，真实的
hometown|家乡，故乡
nowadays|现今，现在，目前
search|搜索，搜查
among|在其中…之一
crayon|彩色铅笔
shame|羞耻
regard|致敬，问候;将…视为
count|计算，计数;有价值
century|世纪，百年
according|依照，按照
opposite|在…对面，与…相对;对面的
especially|特别，尤其
childhood|孩童时期
consider|仔细考虑，思考，注视，
close to|几乎，接近
hold|拥有，抓住